28 28
4
2 0
25 5
20 5
3 0
26 27
1000000001100000000110000000
1100000011110000001111000000
0000000000000000000000000000
1000110001100011000110001100
1000000001100111100110011110
0001111000000111100000011110
0000110000000011000000001100
1100000011110000001111000000
1001001000000111100110011110
1100000011110000001111000000
1000000001100000000110000000
1100000011110000001111000000
0000000000000000000000000000
1000110001100011000110001100
1000000001100111100110011110
0001111000000111100000011110
0000110000000011000000001100
1100000011110000001111000000
1001001000000111100110011110
1100000011110000001111000000
1000000001100000000110000000
1100000011110000001111000000
0000000000000000000000000000
1000110001100011000110001100
1000000001100111100110011110
0001111000000111100000011110
0000110000000011000000001100
1100000011110000001111000000