25 25
1
23 21
11 4
0000000000000000000000000
1001110001100000000110000
1000000001010000000000000
1000000000000011100000000
0000000000000000000000000
1000000001100000000110000
0000000000000000000000000
1000000001100000000110000
0000000000000000000000000
1000000001100000000110000
1000000001100000000110000
1111000000000000000000111
1111000000000000000000111
1111000000000000000000111
1111000000000000000000111
1000000001100000000110000
1111111111100000000000000
1000000001100000000110000
1000000001100000000110000
0000000000000111111111111
0000000000000000000000000
0000000001111000000000000
0000000001111111111000000
1000000001100000000110000
0000000000000000000000000