30 30
3
2 0
28 5
3 0
28 29
100000000110000000011000000001
110000001111000000111100000011
000000000000000000000000000000
100011000110001100011000110001
100000000110011110011001111001
000111100000011110000001111000
000011000000001100000000110000
110000001111000000111100000011
100100100000011110011001111001
110000001111000000111100000011
100000000110000000011000000001
110000001111000000111100000011
000000000000000000000000000000
100011000110001100011000110001
100000000110011110011001111001
000111100000011110000001111000
000011000000001100000000110000
110000001111000000111100000011
100100100000011110011001111001
110000001111000000111100000011
100000000110000000011000000001
110000001111000000111100000011
000000000000000000000000000000
100011000110001100011000110001
100000000110011110011001111001
000111100000011110000001111000
000011000000001100000000110000
110000001111000000111100000011
100100100000011110011001111001
110000001111000000111100000011