20 20
2
1 1
13 15
20 20
00000000000000000000
10000000000000111000
00000000000000000000
10000000011000000001
10000000011000000001
11111111111000000000
10000000011000000001
10000000011000000001
10000000011000000001
11110000000000000000
10011100011000000001
10000000010100000000
11110000000000000000
00000000000001111111
11110000000000000000
10011100011000000001
11110000000000000000
10011100011000000001
10110000000000000000
00000000000000000000